2100123332432356533100P00000233345330
2300003554223254554100000000133444330
2110001443322346654100000012244344445
2300000012211244554310000032234432446
1210000000000122434430000023212310130
2410000000000012322433100024332100000
4440000000000003321355410033422100000
4531000000000001322355430024221221003
4220000000000013333333321134321332000
2100000000000024443432222333213341017
1000000000000244334323122443322442019
0000000000001454334312233334333330000
0000000000001344433322223332222200000
0000000000000245324221001223233210004
0000000000000134432210000124334421133
0001110000000034332120000134342342332
0013310000000014332223000034443234330
0024210000000013542443100024444434329
0031200000000013444444100134556533220
0000000000000013344443201344555553320
0000000000000002444354323443432342337
0000000000000002222444333334421132220
0000000000000000134332244444232221210
0000000000000000133333345541131321230
0000000000000000022333444310002323120
0000002200000000003245321000001343224
0000012200000000000244420000000224320
0000034320000000000132330000001332310
0000033442000000000014420000001442300
0000013343100000000013321000024335310
0000012222100000000002221000123455420
1000022332310000000001232131233454425
2000014334210000000000121343345544328
2000002322100000000000124344465652241
0000000100200000000000133433466454235
0000000000000000000000022232354433430
1000000000000000000000001122343434545
2000000000000000000000001234344344468
2000000000000000000000002235544433463
0000000000000000000000000234544422445
0000000000000000000000000023345533420
0000000000000000000000000001245443328
0000000000000000000000000000014422330
0000000000000000000000000000000133436
0000000000000000000000000000000014435
0000000000000000000000000000000001320
0000000000000000000000000000000000000
0000000000000000000000000000000000002
2000110000000111000000000000000001100
8200892001800876605060000040020019606
