0000000001356521343321000023541000001
0P00000000134320023442100002342000000
0000000000002310013533200002331000000
1000000000000200003454210003332000000
1210000000000000002453320002242100003
1220000000000000000333112000232100000
0000000000000000000023222100012200004
0000000000000000000001223100003300000
0000000000000000000000022100001120005
0000000000000000000000012000000100000
0000000000000000000000000000000000000
0000000010000000000000000000000000001
0000000011100000000000000000000000000
0000000011000000001200000000000000000
1000000000000001122100000000000000002
4200000000000000112200000000000000028
4200000000000000012110000000110000018
3220000000000000002200000002222000000
1110000000000000000000000001232100000
1100000000000000000000000012423200000
2200001100000000000000001223343100001
4200013200000000000000132332322000018
4200012200000000000000234433110000015
4100012000000000000001345542110000000
2000000000000001212113543421000000001
0000000000000003444335542000000000000
0000000000000013444343430000000000000
0000000000000022333423310000000000000
0120000000000122223322100000000000000
2321000000000022224321000000000000000
1334100000000013345421000000000000001
1355200001200023345432000000000000000
2465312223100002445333100000000000000
2444443341000002435553211000000000000
3322443431000001245454443000000001313
3321243330000000133333354100000003220
4422224310000000022222444300000014332
3432224200000000013234342421000024435
2143221000000000003434234342200012435
1233120000000000001322434433310002330
1331111000000000001322334334440001230
1432123300000000000123324444430000220
3231214300000000000023213443321000234
2221012000231000000132212443332000027
2220000002443000000244211344123100124
1221000122331111211443222332213211422
2312212123221232123343243321342322232
4222322343334233434333423222343231223
3223222344455323433323121212311201348
0010550308676700192000300704440030903
